5555555555555555555
5111111115111112115
5155155515155515515
5112111111111111115
5155151555551515515
5111151115111511115
5555155515155515555
   5151115111515
5555151515151515555
1111111511151111111
5555151555551515555
   5151111111515
5555151555551515555
5111111111111111115
5155155515155515515
5115111111111115115
5515151555551515155
5112151115111511215
5155555515155555515
5111111111111111115
5555555555555555555