5555555555555555555
5111111111111111115
5155515555555155515
5111211111111121115
5515551515151555155
5515551515151555155
5515151515151515155
5515151111111515155
5515151511151515155
5115111511151115115
5155151555551515515
1155151111111515511
1155151555551515511
5111111111111111115
5155155555555515515
5111111111111111115
5255555551555555525
5111111551111111115
5555551555551555555
5111111111111111115
5555555555555555555