5555555555555555555
5121111111111111215
5555511515151155555
5111111155511111115
5151515155515151515
5155555555555555515
5115555555555555115
5511551115111551155
5551551511151551555
1111511511151151111
5551115555555111555
5111555551555551115
5111111551551111115
5155151111111515515
5115511555551155115
5511551155511551155
5111155115115511115
5155115511155115515
5155111555551115515
5125511155511555215
5555555555555555555